22333444455555555544444454544444544444455555455555566666666676777665545666666777777877776666656666666666666656666667777666666765555677765566677665443455555455667777777778
23333444455555545544433444444444444454555555555555566666666776777665556666677777777877766666666666666666665555666666667666666765555677765565666655443455555555667777777777
23333444455555555544434445544444444455555556556556666666667777777666556666677777777877766666666666666666555555666666667666666665555677765555566655444444555554566777776777
33334445555556555444333444444444444555555556555556666666667777777666666666677777777777666666666666666666655555666666666666656665556677765555565554443445555555566676677777
34444555555556555444434445555444444555554555555555566555666777777666666666677777777777666666666666776666555555666666667666666665556666665555565555444445555555566666677777
34444555555555555443333344444444444455544445555555566555566777777766666667777777777777666677766666777666555455666666677666666666666676665555555554444445555655555666677777
34444555555455555433334444444444344445544444545455555445556666666666655666777777777777667777766766776666555555666677776656666666666677666555665554454555555544555666666666
34444555555445555444444445454444444444444444444445444444455666556555555566677776776666666777777766666666655555666677766656666666667667666666666555555555555655565666677777
34444555555455555544444444444444444444444444445444444444455555555544444566666666676776666666666766666666655555666777766666666666666666666666666555556655555655566677777666
34444445555555555544444544444444444444434444545444434444444444444444445566666666676666666666666666666676555555566676655556666566666666666666666555555555545554556677776666
33344445555555555444455555444444445444444555555443333444434344444333344555555566666666666665556666666666665665666776655556666566666666666666666655556555555555566677777676
34444545555555555555455545444443445554445556655544334444434444444333344555555556666776666555555666666666666666666666655566666566566656666656566655556565554555566666777777
34444545555555555555555544443443444454445555555544434444444444444434344555555566667666665555555667777776666666666776655566666666665556665555556555555555554555566666777676
34444555565555445555555555444443444444344545555444444444444444444444444555555455566666665555666667766666666666666666666666666666665556665555556665555555555555566666666777
34344455656554444555565555444444444444445445545445445545554555554444444445555455556556655555667777766666666666667777766666666666665556666555455566555556555666666666666666
34444555656555555666666555444444443344444445555455555555555555555555555555544345455555554555677777766666666666767776777666666666655556666555555556556555555666665556666666
34334445555554545555565555444444443333344445555444444445555555555555565555444345445444544555677777766666665566677777777666666666665555666555555666666556566777665556566666
44333445655444444555555555555444443443444455555444445544444555555556666665544344445444454556677777766655666666667777777666566667666666666665555566666656666776665555566666
44433444554444444444455555455444433444444455555444444554545555555566666655544444444444444556677777766665566666666776666666666667666656666666655556666666677766555545566666
44443444454444444444455544444444433333444445554443444444445556555566677655444444444444444456666676665555666666666777666666666667777766665666666666666666676666565555566677
44343444444444443444444444444444433444444444555444444455555556566666676655554444444444444555666777665555666655666777676777666667777777665555666666666666777776666666666666
44343444444444444444444444444444433444444445544444555555555566666667676655555554444455454555566667665655667766666777666666666667777766666665666666556666666666666666666677
33333333344445444434444444444444433444445445545555555555556566667777776655555544455555555555566667665655666666666666666667766666777766666666677666556666666666666666676677
33343433344444445444444444344433333444545455545555666555445566777777766655555544555555566655556666655656666766666667666766666566677777766666677766555656666666666666777777
33333333333344444444443434344434333445555555655555666666556776677777665555555444555555566665666677666666666766666666666666555566666666666666667665545666666666666666666666
33344443343334344444433333334333333445556555544445576665767677766666766555555555565555556556667767666666677777776666556655555556666666676666666666555555665666666666666666
34444443333333334444443334333333333344455555544455565555777676666666676555545455665555555566667777666666666777777666556655455555566666666666666666555556666665666666666666
34444444333333334444443333333333333344445545544455565554445566666776666565545555555454555555667777666666677777777766655554454455566666566666666666666666666666666666666766
34443443433333334444333333333334444444455545444555565444455666666766666665444455554444444455556666676767677676676666665554555556565666566666656666666666666665666666666666
44454544433333334443333333333445454445455555544555554444455666666666666665545555554445555444455666666666666666666666665555555555565565566667666666666676666655555666666766
44444443333333333333334334334455555444445545545555654444555666666666666655445565554455555554555555666666666565566666665555565566666655566677666666667777767665665666666666
44454444433333344333333333334455555545556555545555655444455666666666666554545665555555555554545555565665566565555666666655665556666666677676666666667777766666666666666666
44455544433333333333344443334456665555566655555555655444555655566655556555555666555556666555555555555555555554555566666665666666666666676777766666677777776676777666666655
54455545443332333344444444334455555445566556555556666555555555565555556665556666665666666655566665555555555554555666665666666566666666666677776666677777777777777766666666
55455455443332333444445554445455555555566555555555666655555545555555556565556666666666666555556655554444555444555666555555555556666777777777776677677766667777767666666666
55455555544333334444455555555455555555566666555555666665555544455555556555555555666666655544555655544444555544455555555555555555556667777777776777777666667777767666666666
55445555544333333344455565556566655555566665555566666666555544445555555555555555555565655444445555544455554444445555555555555555556666777777766667776666777777666666666666
44444555443333334344455566666666656555656655555556666666555444444445555555554555555555544444444544444444554444444555555555555555555566677666666667766666677776556667667667
44445444443333333344455566666666656656666655554455655555555544444444444444444455555445544444444444444444444444444556665555555555556666777767666667766666667666556667767777
33434433443333344445455556666666656555555555444455555544444555444455554444444554444444444344444444444545554444444455666655665555555667777766666666777766767666656666667777
43434443433333444454455556666665656555544554444445544444455555554444444444444554444444444344444444444555544444454556666656666555555666777766666666667666777676656566667777
33333333333334455555444556666555555554444444444444444444455565554454444444444554444444444334445545444444544444454556666666676555555666777766666666667777777776666666666777
33333333333344455555444456655544445454445544433444444444445555555555554444444544444555444334444445444444444444454556666666676555556666776666666556667777777777666666666777
33333334444445555555443445555544444454445444444111111111178654637867865554554554555554443334445555444444444444444555565556666555556666666666566666677777777777666666666777
33333334444445555544443445555444444444444444433111111111167865437865555555544444555554444444455555444444444444555566655566666666666666566666666666677777777777776666666777
33333333344445454444343444554444444444444444434111111111145687645678654655554444555554444445566555444444444444455566666566666676666665556666666666666666666666666666556667
33333333444445444433333344444433334444444444476111111111156753756756735555554444556655444445556655444444444544454565555555665666666555556566666666666555566666666665556666
33333334444444444333333444443334344433333344499111111111134343434343433999984444556665544445566655444444444444455565555555555666655555556666666776665555566555556555555566
33333333444433333333344545544334444433333443332333443333333333333333444555444444556666555455666655444444444544455555555445555566555455556666666666655555556555555554445556
33322333444443333333444555544444444444444444333334443333334443333333444544444445556666655455556554443334444443444555544444445555555445545555556666555455555554544444444445
33332333444444434334445555554444444444444443333434433333444343333344444444444445556667665555555555443334444444455555444444444444555545545555556666555555666655544554444444
33332344444444333334445555555555555555544443444444443333444443333444444444333345456566655555555555544333344444555665554444444555555555555554556666555556666655544444444444
34333344444444444333334455556655555555554444444444333333444443333343344444344345445556666555555665554334444554555565655544545555556555555555555556555556666655544444443344
33333444443343333333334445555555555555554444444443333333444443444443344444444455555555655555555555444434455555556666655555555555555555555554556656555656666655544443333343
33333444443333344333334455555555555555555444444433333334445444444444444444444445555555555555566665554444455555555666666655555566666655655555555556555666666555544444333333
33333433343433333333344455555545545555555444444433333444555444444443334344444445555555555556666655554445555544445666655555555666666666666655556666556666665555544444333344
22333333444433333333333455555555555544555544444433334455555444444443344444544555555555555566655554455555454444445555555555555666777766666666566666666666665555544444333333
22333333344433333333444555555545555555555544444444444555554444454444334444544545555554444556555544454445444444445555555555555667777666666666666666666666665555554443333233
22333333444443333333344455555555545545555444444444444555544444444444444444444544555554444556555555555555444334445555544545555667777777666666667666666777665555554444333333
22233333444433333333333444444555555545544444444445555555544444554444444444445555554544444455555445555555444344455555444545555666777776666566667666666666655555544444433333
22333333444443344333333444444445555555555555455556555555544444444444444433344555444444444444444455555555444445555555555555556666666666666556566666666666655555444444433322
33343333344333334433333333344445555554444455556655555555544444454444444433344555544443443344445555655555445555555666555555566666665666665555556656556666655555443444333332
33333333343333333333333333334444444455444445555555555555554444444444444443344555543433343333334455566555555666666666655555566676666666666655566555556667666655443344333322
33333333443333344444333333343444455454444445555555555555544444444444443443344555544443343333334455556555556666666677666556666666655555666665566555556666666655444434333332
33333333443333444443333333344333444444444445555555565665554444444444444443344555554433333333434455666666556666665566666555666676666656666666666555566667666665544444443333
34333333443343343343344444444444344444444445545555555555544444444444445555455555554444444444444455666655556666665566666666666676666556666666666555556667766665554444444333
44333334444444443333444444444443344444445445444555565665544445554444455555555555555555455544444455565655666666666666666666666676666556666666666665556667766665655555554443
44433344444443333333444454444433344444444445454555566665443445555555555666555555555555555555555555666656666766665666666677766666666655666666666555566667766665655555555554
44434334444443333333444454443333333344444444555555566665543445565666666776655565555556666655555556665656666766666666666667766677766655666767766655556667766665666666655555
54443334444433333333445554443444343445555555555555556655443445566665556677665565555566667665555555555555666766666677677777777777666655667766766655556677766655666666655555
